3,50,50,8,8,40,3,1
0 0 0 0 0 0 0 0 0 0 0 0 0 0 0 0 0 0 0 0 0 0 0 0 0 0 0 0 0 0 0 0 0 0 0 0 0 0 0 0 0 0 0 0 0 0 0 0 0 0 
0 0 0 0 0 0 0 0 0 0 0 0 0 0 0 0 0 0 0 0 0 0 0 0 0 0 0 0 0 0 0 0 0 0 0 0 0 0 0 0 0 0 0 0 0 0 0 0 0 0 
0 0 0 0 0 0 0 0 0 0 0 0 0 0 0 0 0 0 0 0 0 0 0 0 0 0 0 0 0 0 0 0 0 0 0 0 0 0 0 0 0 0 0 0 0 0 0 0 0 0 
0 0 0 8 7 7 7 7 7 7 7 7 7 7 7 7 7 7 7 7 7 7 7 7 7 7 7 7 7 7 7 7 7 7 7 7 7 7 7 7 7 7 7 7 9 0 0 0 0 0 
0 0 0 10 18 19 85 85 85 85 85 85 85 85 85 85 85 85 85 85 85 85 85 11 85 85 85 85 85 85 18 19 85 85 85 85 85 85 85 85 85 85 18 19 6 0 0 0 0 0 
0 0 0 10 16 17 85 85 85 85 85 85 85 85 85 85 85 85 85 85 85 85 85 11 85 85 85 85 85 85 16 17 85 85 85 85 85 85 85 85 85 85 16 17 6 0 0 0 0 0 
0 0 0 10 85 85 11 11 11 11 11 11 111 111 84 84 11 11 11 11 11 11 11 11 11 11 11 11 11 11 11 11 11 11 11 11 11 11 11 11 11 14 85 85 6 0 0 0 0 0 
0 0 0 10 85 85 11 11 11 12 11 11 112 112 84 84 11 11 11 11 11 11 11 11 11 11 11 11 15 11 11 11 11 11 11 13 11 11 11 11 11 11 85 85 6 0 0 0 0 0 
0 0 0 10 85 85 11 11 11 11 11 11 11 14 84 84 11 11 11 84 84 11 11 11 22 23 84 84 84 11 11 11 84 84 86 86 86 86 86 11 11 11 85 85 6 0 0 0 0 0 
0 0 0 10 85 85 13 11 11 84 84 84 84 84 84 84 11 11 11 84 84 11 11 11 20 21 84 84 84 11 11 11 84 84 86 86 86 86 86 11 11 11 85 85 6 0 0 0 0 0 
0 0 0 10 85 85 11 11 11 84 84 84 84 84 84 84 11 11 11 84 84 11 11 11 84 84 11 11 11 11 11 11 84 84 11 11 11 11 11 11 11 12 85 85 6 0 0 0 0 0 
0 0 0 10 85 85 11 11 11 11 11 11 11 11 11 11 11 12 11 84 84 11 11 11 84 84 11 11 11 11 11 11 84 84 111 111 11 11 11 11 11 11 85 85 6 0 0 0 0 0 
0 0 0 10 85 85 11 11 11 11 11 11 11 11 11 11 11 11 11 84 84 11 13 11 84 84 11 11 11 11 11 11 84 84 112 112 11 11 11 11 11 11 85 85 6 0 0 0 0 0 
0 0 0 10 85 85 84 84 84 84 84 84 84 22 23 84 84 84 84 84 84 11 11 11 84 84 11 11 11 84 84 84 84 84 84 84 84 22 23 11 11 11 85 85 6 0 0 0 0 0 
0 0 0 10 85 85 84 84 84 84 84 84 84 20 21 84 84 84 84 84 84 11 11 11 84 84 11 11 11 84 84 84 84 84 84 84 84 20 21 11 11 11 18 19 6 0 0 0 0 0 
0 0 0 10 85 85 11 11 11 11 11 11 11 86 86 11 11 11 11 11 11 11 11 11 84 84 11 11 11 11 11 11 11 11 11 11 11 84 84 11 11 11 16 17 6 0 0 0 0 0 
0 0 0 10 85 85 11 11 11 11 11 11 11 86 86 11 11 11 11 11 11 11 11 11 84 84 11 11 11 11 11 11 11 11 11 11 11 84 84 11 11 11 85 85 6 0 0 0 0 0 
0 0 0 10 85 85 11 11 11 11 11 11 11 86 86 11 11 11 11 11 11 11 11 11 84 84 11 11 11 11 11 12 11 11 11 11 11 84 84 11 11 11 85 85 6 0 0 0 0 0 
0 0 0 10 85 85 11 11 11 84 84 11 11 86 86 11 11 11 84 84 84 84 84 84 84 84 84 22 23 11 11 11 86 86 11 11 11 84 84 11 11 11 85 85 6 0 0 0 0 0 
0 0 0 10 85 85 11 11 11 84 84 11 11 86 86 11 11 11 84 133 131 131 131 131 131 131 131 20 21 11 11 11 86 86 11 11 11 84 84 11 13 11 85 85 6 0 0 0 0 0 
0 0 0 10 85 85 11 11 11 22 23 11 11 11 11 11 11 11 84 133 175 3 3 3 3 3 176 137 84 11 11 11 86 86 11 11 11 84 84 11 11 11 85 85 6 0 0 0 0 0 
0 0 0 10 18 19 11 11 11 20 21 11 11 11 11 11 14 11 84 133 6 0 0 107 0 0 10 137 84 11 11 11 86 86 11 11 11 84 84 84 84 84 85 85 6 0 0 0 0 0 
0 0 0 10 16 17 11 11 11 84 84 84 84 84 84 84 84 84 84 133 6 0 107 0 107 0 10 137 84 11 11 11 86 86 11 11 11 84 84 84 84 84 85 85 6 0 0 0 0 0 
0 0 0 10 85 85 11 12 11 84 84 84 84 84 84 84 84 84 84 133 6 107 0 0 0 107 10 137 84 11 14 11 86 86 11 11 11 11 11 11 11 11 85 85 6 0 0 0 0 0 
0 0 0 10 85 85 11 11 11 84 84 11 11 11 11 11 11 11 84 133 6 0 107 0 107 0 10 137 84 11 11 11 86 86 11 11 11 11 11 11 11 15 85 85 6 0 0 0 0 0 
0 0 0 10 85 85 11 11 11 84 84 11 11 11 11 11 11 11 84 133 177 7 7 7 7 7 178 137 84 11 11 11 86 86 11 11 11 11 11 11 11 11 85 85 6 0 0 0 0 0 
0 0 0 10 85 85 11 11 11 84 84 11 11 84 84 84 84 84 84 133 134 134 134 134 11 11 11 137 84 11 11 11 84 84 84 22 23 84 84 11 11 11 85 85 6 0 0 0 0 0 
0 0 0 10 85 85 11 11 11 84 84 11 11 84 84 84 84 84 84 84 84 84 84 84 11 11 11 84 84 11 11 11 84 84 84 20 21 84 84 11 11 11 85 85 6 0 0 0 0 0 
0 0 0 10 85 85 11 11 11 84 84 11 11 11 11 11 11 11 11 11 11 11 84 84 11 11 11 22 23 11 11 11 11 11 11 11 11 84 84 11 11 11 85 85 6 0 0 0 0 0 
0 0 0 10 85 85 11 11 11 84 84 11 11 11 11 11 11 11 11 11 11 11 84 84 11 11 11 20 21 11 11 11 11 11 11 11 11 84 84 11 11 11 85 85 6 0 0 0 0 0 
0 0 0 10 85 85 13 11 11 84 84 11 11 11 11 11 13 11 11 11 11 11 84 84 11 11 11 84 84 11 11 11 13 11 11 11 11 84 84 11 11 11 85 85 6 0 0 0 0 0 
0 0 0 10 18 19 11 11 11 84 84 11 11 11 11 11 11 11 11 11 11 11 84 84 11 11 11 84 84 11 11 11 11 11 11 11 11 84 84 14 11 11 85 85 6 0 0 0 0 0 
0 0 0 10 16 17 11 11 11 84 84 22 23 84 84 84 84 84 84 84 11 11 84 84 11 12 11 84 84 84 84 84 84 84 11 11 11 84 84 11 11 11 85 85 6 0 0 0 0 0 
0 0 0 10 85 85 11 11 11 84 84 20 21 84 84 84 84 84 84 84 11 11 84 84 11 11 11 84 84 84 84 84 84 84 11 11 11 84 84 11 11 11 18 19 6 0 0 0 0 0 
0 0 0 10 85 85 11 11 11 11 11 11 11 11 11 11 11 11 84 84 13 11 84 84 11 11 11 84 84 11 11 11 11 11 11 11 11 84 84 11 11 11 16 17 6 0 0 0 0 0 
0 0 0 10 85 85 11 11 11 11 11 11 11 11 11 11 111 111 84 84 11 11 84 84 11 11 11 84 84 111 111 11 11 11 11 11 11 84 84 11 11 11 85 85 6 0 0 0 0 0 
0 0 0 10 85 85 11 11 11 11 11 11 11 11 11 11 112 112 84 84 11 11 22 23 11 11 11 84 84 112 112 11 11 11 11 11 11 84 84 11 11 11 85 85 6 0 0 0 0 0 
0 0 0 10 85 85 86 86 86 86 11 11 11 84 84 22 23 84 84 84 11 11 20 21 11 11 11 84 84 84 84 84 84 84 84 22 23 84 84 11 11 11 85 85 6 0 0 0 0 0 
0 0 0 10 85 85 86 86 86 86 11 11 11 84 84 20 21 84 84 84 11 11 86 86 11 11 11 84 84 84 84 84 84 84 84 20 21 84 84 11 11 11 85 85 6 0 0 0 0 0 
0 0 0 10 85 85 11 11 11 11 11 11 11 11 11 11 11 11 11 11 11 11 86 86 11 11 11 11 11 11 11 11 11 11 11 11 11 11 11 11 12 11 85 85 6 0 0 0 0 0 
0 0 0 10 85 85 11 11 11 11 11 11 11 11 11 11 11 11 11 11 11 11 86 86 11 11 11 11 11 11 11 11 11 11 11 11 11 11 11 11 11 11 85 85 6 0 0 0 0 0 
0 0 0 10 85 85 11 14 11 11 11 11 11 12 11 11 11 11 11 11 11 14 86 86 11 11 11 11 11 15 11 11 11 11 11 11 11 11 11 11 11 11 85 85 6 0 0 0 0 0 
0 0 0 10 85 85 85 85 85 85 85 85 18 19 85 85 85 85 85 85 85 85 85 85 85 85 85 85 85 85 85 85 85 85 85 85 85 85 85 85 85 85 18 19 6 0 0 0 0 0 
0 0 0 10 85 85 85 85 85 85 85 85 16 17 85 85 85 85 85 85 85 85 85 85 85 85 85 85 85 85 85 85 85 85 85 85 85 85 85 85 85 85 16 17 6 0 0 0 0 0 
0 0 0 4 3 3 3 3 3 3 3 3 3 3 3 3 3 3 3 3 3 3 3 3 3 3 3 3 3 3 3 3 3 3 3 3 3 3 3 3 3 3 3 3 5 0 0 0 0 0 
0 0 0 0 0 0 0 0 0 0 0 0 0 0 0 0 0 0 0 0 0 0 0 0 0 0 0 0 0 0 0 0 0 0 0 0 0 0 0 0 0 0 0 0 0 0 0 0 0 0 
0 0 0 0 0 0 0 0 0 0 0 0 0 0 0 0 0 0 0 0 0 0 0 0 0 0 0 0 0 0 0 0 0 0 0 0 0 0 0 0 0 0 0 0 0 0 0 0 0 0 
0 0 0 0 0 0 0 0 0 0 0 0 0 0 0 0 0 0 0 0 0 0 0 0 0 0 0 0 0 0 0 0 0 0 0 0 0 0 0 0 0 0 0 0 0 0 0 0 0 0 
0 0 0 0 0 0 0 0 0 0 0 0 0 0 0 0 0 0 0 0 0 0 0 0 0 0 0 0 0 0 0 0 0 0 0 0 0 0 0 0 0 0 0 0 0 0 0 0 0 0 
0 0 0 0 0 0 0 0 0 0 0 0 0 0 0 0 0 0 0 0 0 0 0 0 0 0 0 0 0 0 0 0 0 0 0 0 0 0 0 0 0 0 0 0 0 0 0 0 0 0 

0 0 0 0 0 0 0 0 0 0 0 0 0 0 0 0 0 0 0 0 0 0 0 0 0 0 0 0 0 0 0 0 0 0 0 0 0 0 0 0 0 0 0 0 0 0 0 0 0 0 
0 0 0 0 0 0 0 0 0 0 0 0 0 0 0 0 0 0 0 0 0 0 0 0 0 0 0 0 0 0 0 0 0 0 0 0 0 0 0 0 0 0 0 0 0 0 0 0 0 0 
0 0 0 0 0 0 0 0 0 0 0 0 0 0 0 0 0 0 0 0 0 0 0 0 0 0 0 0 0 0 0 0 0 0 0 0 0 0 0 0 0 0 0 0 0 0 0 0 0 0 
0 0 0 0 0 0 0 0 0 0 0 0 0 0 0 0 0 0 0 0 0 0 0 0 0 0 0 0 0 0 0 0 0 0 0 0 0 0 0 0 0 0 0 0 0 0 0 0 0 0 
0 0 0 0 0 0 0 0 0 0 0 0 0 0 0 0 0 0 0 0 0 0 0 0 0 0 0 0 0 0 0 0 0 0 0 0 0 0 0 0 0 0 0 0 0 0 0 0 0 0 
0 0 0 0 0 0 0 0 0 0 0 0 0 0 0 0 0 0 0 0 0 0 0 3 0 0 0 0 0 0 0 0 0 0 0 0 0 0 0 0 0 0 0 0 0 0 0 0 0 0 
0 0 0 0 0 0 0 0 0 0 0 0 0 0 0 0 0 0 0 0 0 0 0 0 0 0 0 99 0 0 0 0 0 0 0 0 0 0 0 0 0 0 0 0 0 0 0 0 0 0 
0 0 0 0 0 0 0 0 0 0 0 0 0 0 0 0 0 0 0 0 0 0 1 0 0 0 0 0 0 0 0 0 0 0 0 0 0 0 0 0 0 0 0 0 0 0 0 0 0 0 
0 0 0 0 0 0 0 0 0 0 0 0 0 0 0 0 0 0 0 0 0 0 0 0 0 0 0 0 0 0 0 0 0 0 0 0 0 0 0 0 0 0 0 0 0 0 0 0 0 0 
0 0 0 0 0 0 0 0 0 0 0 0 0 0 0 0 0 0 0 0 0 0 0 0 0 0 0 0 0 0 0 0 0 0 0 0 0 0 0 0 0 0 0 0 0 0 0 0 0 0 
0 0 0 0 0 0 0 0 0 0 0 0 0 0 0 0 0 0 0 0 0 0 0 0 0 0 0 0 0 0 0 0 0 0 0 0 0 0 0 0 0 0 0 0 0 0 0 0 0 0 
0 0 0 0 0 0 0 0 0 0 0 0 0 0 0 0 0 0 0 0 0 0 0 0 0 0 0 0 0 0 0 0 0 0 0 0 0 0 0 0 0 0 0 0 0 0 0 0 0 0 
0 0 0 0 0 0 0 0 1 0 0 0 0 0 0 0 0 0 0 0 0 0 0 0 0 0 0 0 0 0 0 0 0 0 0 0 0 0 0 0 0 0 0 0 0 0 0 0 0 0 
0 0 0 0 0 0 0 0 0 0 0 0 0 0 0 0 0 0 0 0 0 0 0 0 0 0 0 0 0 0 0 0 0 0 0 0 0 0 0 0 0 0 0 0 0 0 0 0 0 0 
0 0 0 0 0 0 0 0 0 0 0 0 0 0 0 0 0 0 0 0 0 0 0 0 0 0 0 0 0 0 0 0 0 0 0 0 0 0 0 0 0 0 0 0 0 0 0 0 0 0 
0 0 0 0 0 0 5 0 0 0 0 0 0 0 0 0 0 0 0 0 0 0 0 0 0 0 0 0 0 0 0 0 0 0 0 0 5 0 0 0 0 0 0 0 0 0 0 0 0 0 
0 0 0 0 0 0 0 0 0 0 0 0 0 0 0 0 0 0 0 0 0 0 0 0 0 0 0 0 0 0 0 0 0 0 0 0 0 0 0 0 0 0 0 0 0 0 0 0 0 0 
0 0 0 0 0 0 0 0 0 0 0 0 0 0 0 0 0 0 0 0 0 0 0 5 0 0 0 0 0 0 0 0 0 0 0 0 0 0 0 0 0 0 0 0 0 0 0 0 0 0 
0 0 0 0 0 0 0 0 0 0 0 0 0 0 0 0 0 0 0 0 0 0 0 0 0 0 0 0 0 0 0 0 0 0 0 0 0 0 0 0 0 1 0 0 0 0 0 0 0 0 
0 0 0 0 0 0 0 0 0 0 0 0 0 0 0 0 0 0 0 0 0 0 0 0 0 0 0 0 0 0 0 0 0 0 0 0 0 0 0 0 0 0 0 0 0 0 0 0 0 0 
0 0 0 0 0 0 0 0 0 0 0 0 0 0 0 0 0 1 0 0 0 0 0 0 0 0 0 0 0 0 0 0 0 0 0 0 0 0 0 0 0 0 0 0 0 0 0 0 0 0 
0 0 0 0 0 0 0 0 0 0 0 0 0 0 0 0 0 0 0 0 0 0 0 0 0 0 0 0 0 0 0 0 0 0 0 0 0 0 0 0 0 0 0 0 0 0 0 0 0 0 
0 0 0 0 0 0 1 0 0 0 0 0 0 0 0 0 0 0 0 0 0 0 0 0 0 0 0 0 0 0 0 0 0 0 0 0 0 0 0 0 0 0 0 0 0 0 0 0 0 0 
0 0 0 0 0 0 0 0 0 0 0 0 0 0 0 0 0 0 0 0 0 0 0 2 0 0 0 0 0 0 0 0 0 0 0 0 0 0 0 0 0 0 0 0 0 0 0 0 0 0 
0 0 0 0 0 0 0 0 0 0 0 0 0 0 0 1 0 0 0 0 0 0 0 0 0 0 0 0 0 0 0 0 0 0 0 0 0 0 0 0 0 0 0 0 0 0 0 0 0 0 
0 0 0 0 0 0 0 0 0 0 0 0 0 0 0 0 0 0 0 0 0 0 0 0 0 0 0 0 0 0 0 0 0 0 0 0 0 0 0 0 0 0 0 0 0 0 0 0 0 0 
0 0 0 0 0 0 0 0 0 0 0 0 0 0 0 0 0 0 0 0 0 0 0 0 0 0 0 0 0 0 0 0 0 0 0 0 0 0 0 0 0 0 0 0 0 0 0 0 0 0 
0 0 0 0 0 0 0 0 0 0 0 0 0 0 0 0 0 0 0 0 0 0 0 0 0 0 0 0 0 0 0 0 0 0 0 0 0 0 0 0 0 0 0 0 0 0 0 0 0 0 
0 0 0 0 0 0 0 0 0 0 0 0 0 0 0 0 0 0 0 0 0 0 0 0 0 0 0 0 0 0 0 0 0 0 0 0 0 0 0 0 0 0 0 0 0 0 0 0 0 0 
0 0 0 0 0 0 0 0 0 0 0 0 0 0 0 0 0 0 0 0 0 0 0 0 0 0 0 0 0 0 0 0 0 0 0 5 0 0 0 0 0 0 0 0 0 0 0 0 0 0 
0 0 0 0 0 0 0 0 0 0 0 0 0 0 0 0 0 0 0 0 0 0 0 0 0 0 0 0 0 0 0 0 0 0 0 0 0 0 0 0 0 0 0 0 0 0 0 0 0 0 
0 0 0 0 0 0 0 0 0 0 0 0 0 0 0 0 0 0 0 0 0 0 0 0 0 0 0 0 0 0 0 0 0 0 0 0 0 0 0 0 0 0 0 0 0 0 0 0 0 0 
0 0 0 0 0 0 0 0 0 0 0 0 0 0 0 0 0 0 0 0 0 0 0 0 0 0 0 0 0 0 0 0 0 0 0 0 0 0 0 0 0 0 0 0 0 0 0 0 0 0 
0 0 0 0 0 0 0 0 0 0 0 0 0 0 0 0 0 0 0 0 0 0 0 0 0 0 0 0 0 0 0 0 0 0 0 0 0 0 0 0 0 0 0 0 0 0 0 0 0 0 
0 0 0 0 0 0 0 0 0 0 0 0 0 0 0 0 0 0 0 0 0 0 0 0 0 0 0 0 0 0 0 0 0 0 0 0 0 0 0 0 0 0 0 0 0 0 0 0 0 0 
0 0 0 0 0 0 0 0 0 0 0 0 0 0 1 0 0 0 0 0 0 0 0 0 0 0 0 0 0 0 0 0 0 0 0 0 0 0 0 0 0 0 0 0 0 0 0 0 0 0 
0 0 0 0 0 0 0 0 0 5 0 0 0 0 0 0 0 0 0 0 0 0 0 0 0 0 0 0 0 0 0 0 1 0 0 0 0 0 0 0 0 0 0 0 0 0 0 0 0 0 
0 0 0 0 0 0 0 0 0 0 0 0 0 0 0 0 0 0 0 0 0 0 0 0 0 0 0 0 0 0 0 0 0 0 0 0 0 0 0 0 0 0 0 0 0 0 0 0 0 0 
0 0 0 0 0 0 0 0 0 0 0 0 0 0 0 0 0 0 0 0 0 0 0 0 0 0 0 0 0 0 0 0 0 0 0 0 0 0 0 0 0 0 0 0 0 0 0 0 0 0 
0 0 0 0 0 0 0 0 0 0 0 0 0 0 0 0 0 0 0 0 0 0 0 0 0 0 0 5 0 0 0 0 0 0 0 0 0 0 0 0 0 0 0 0 0 0 0 0 0 0 
0 0 0 0 0 0 0 99 0 0 0 0 0 0 0 0 0 0 0 0 0 0 0 0 0 0 0 0 0 0 0 0 0 0 0 0 0 0 0 0 0 0 0 0 0 0 0 0 0 0 
0 0 0 0 0 0 0 0 0 0 0 0 0 0 0 0 0 0 0 0 0 0 0 0 0 0 0 0 0 0 0 0 0 0 0 0 0 0 0 0 99 0 0 0 0 0 0 0 0 0 
0 0 0 0 0 0 0 0 0 0 0 0 0 0 0 0 0 0 0 0 0 0 0 0 0 0 0 0 0 0 0 0 0 0 0 0 0 0 0 0 0 0 0 0 0 0 0 0 0 0 
0 0 0 0 0 0 0 0 0 0 0 0 0 0 0 0 0 0 0 0 0 0 0 0 0 0 0 0 0 0 0 0 0 0 0 0 0 0 0 0 0 0 0 0 0 0 0 0 0 0 
0 0 0 0 0 0 0 0 0 0 0 0 0 0 0 0 0 0 0 0 0 0 0 0 0 0 0 0 0 0 0 0 0 0 0 0 0 0 0 0 0 0 0 0 0 0 0 0 0 0 
0 0 0 0 0 0 0 0 0 0 0 0 0 0 0 0 0 0 0 0 0 0 0 0 0 0 0 0 0 0 0 0 0 0 0 0 0 0 0 0 0 0 0 0 0 0 0 0 0 0 
0 0 0 0 0 0 0 0 0 0 0 0 0 0 0 0 0 0 0 0 0 0 0 0 0 0 0 0 0 0 0 0 0 0 0 0 0 0 0 0 0 0 0 0 0 0 0 0 0 0 
0 0 0 0 0 0 0 0 0 0 0 0 0 0 0 0 0 0 0 0 0 0 0 0 0 0 0 0 0 0 0 0 0 0 0 0 0 0 0 0 0 0 0 0 0 0 0 0 0 0 
0 0 0 0 0 0 0 0 0 0 0 0 0 0 0 0 0 0 0 0 0 0 0 0 0 0 0 0 0 0 0 0 0 0 0 0 0 0 0 0 0 0 0 0 0 0 0 0 0 0 
0 0 0 0 0 0 0 0 0 0 0 0 0 0 0 0 0 0 0 0 0 0 0 0 0 0 0 0 0 0 0 0 0 0 0 0 0 0 0 0 0 0 0 0 0 0 0 0 0 0 
