6 7 7 7 7 7 7 7 7 7 7 7 7 7 7 8
4 0 0 0 0 0 0 0 0 0 0 0 0 0 0 5
4 0 0 0 0 0 0 0 0 0 0 0 0 0 0 5
4 0 0 0 0 0 0 0 0 0 0 0 0 0 0 5
4 0 0 0 0 0 0 0 0 0 0 0 0 0 0 5
4 0 0 11 12 0 0 0 0 0 0 0 0 0 0 5
4 0 0 9 10 0 0 0 0 0 0 0 0 0 0 5
4 0 0 0 0 0 0 0 0 0 0 0 0 0 0 5
4 0 0 0 0 0 0 0 0 0 0 0 0 0 0 5
4 0 0 0 0 0 0 0 0 15 16 0 0 0 0 5
4 0 0 0 0 0 0 0 0 13 14 0 0 0 0 5
4 0 0 0 0 0 0 0 0 0 0 0 0 0 0 5
4 0 0 0 0 0 0 0 0 0 0 0 0 0 0 5
4 0 0 0 0 0 0 0 0 0 0 0 0 0 0 5
4 0 0 0 0 0 0 0 0 0 0 0 0 0 0 5
1 2 2 2 2 2 2 2 2 2 2 2 2 2 2 3