FIELD1,50,50,9,7,40,1,2
41 41 41 41 41 41 40 11 11 11 11 11 36 41 41 41 41 41 41 41 41 41 41 41 41 41 41 41 41 41 41 41 41 41 41 41 40 29 6 0 0 0 0 10 29 36 41 41 41 41 
41 41 41 41 41 41 40 11 93 93 93 11 36 41 41 41 41 41 41 41 41 41 41 41 41 41 41 41 41 41 41 41 41 41 41 41 40 29 6 0 0 0 0 10 29 36 41 41 41 41 
41 41 41 41 41 41 40 11 93 93 93 11 36 41 41 41 41 41 41 41 41 41 41 41 41 41 41 41 41 41 41 41 41 41 41 41 40 29 6 0 0 0 0 10 29 36 41 41 41 41 
41 41 41 41 41 41 40 11 93 93 93 11 36 41 41 41 41 41 41 41 41 41 41 41 41 41 41 41 41 41 41 41 41 41 41 41 40 29 121 7 7 7 7 120 29 36 41 41 41 41 
41 41 41 41 41 41 40 98 98 11 98 98 117 34 34 34 34 34 34 34 34 34 34 34 34 34 34 34 34 34 34 34 34 34 34 34 114 29 98 98 11 98 98 98 29 36 41 41 41 41 
41 41 41 41 41 41 40 99 99 11 99 99 11 11 82 83 11 11 98 118 3 3 3 3 3 3 3 3 3 3 3 3 119 98 11 84 11 24 99 99 11 99 99 99 26 36 41 41 41 41 
41 41 41 41 41 41 40 118 3 3 87 3 3 3 3 3 3 119 99 6 0 100 0 100 0 100 0 100 0 100 0 100 10 99 11 11 11 84 11 11 11 11 11 11 11 36 41 41 41 41 
41 41 41 41 41 41 40 6 100 2 101 1 102 0 104 0 103 10 29 6 101 0 101 0 101 0 101 0 101 0 101 0 10 29 11 11 11 11 11 11 11 11 84 11 11 36 41 41 41 41 
41 41 41 41 41 41 40 6 100 2 101 1 102 2 104 0 103 10 98 6 0 102 0 102 0 102 0 102 0 102 0 102 10 98 84 11 11 11 11 11 11 11 11 11 11 36 41 41 41 41 
41 41 41 41 41 41 40 6 100 2 101 1 102 1 104 0 103 10 99 121 7 7 7 7 7 7 7 7 7 7 7 7 120 99 11 11 11 11 11 11 11 84 11 11 84 36 41 41 41 41 
41 41 41 41 41 41 40 6 100 2 0 1 102 1 104 0 103 10 115 38 38 38 38 38 38 38 38 38 38 38 38 38 38 116 11 11 84 11 11 11 11 11 11 11 11 36 41 41 41 41 
41 41 41 41 41 41 40 6 100 2 101 1 102 2 104 0 103 10 36 41 41 41 41 41 41 41 41 41 41 41 41 41 41 40 98 11 98 11 98 11 98 11 98 11 98 36 41 41 41 41 
41 41 41 41 41 41 40 6 100 2 101 1 102 0 104 0 103 10 117 34 34 34 34 34 34 34 34 34 34 34 34 34 34 114 99 31 99 31 99 11 99 31 99 31 99 36 41 41 41 41 
41 41 41 41 41 41 40 6 100 0 101 1 0 1 104 0 2 10 93 93 93 93 93 93 93 93 93 93 93 93 93 93 93 93 11 11 11 11 11 11 11 87 11 11 11 36 41 41 41 41 
41 41 41 41 41 41 40 6 100 0 101 0 102 0 104 0 2 10 93 93 93 93 93 93 93 93 93 93 93 93 93 93 93 93 11 11 11 85 11 11 11 11 18 19 11 36 41 41 41 41 
41 41 41 41 41 41 40 6 100 0 101 0 102 0 104 0 0 10 93 93 93 93 93 93 93 93 93 93 93 93 93 93 93 93 11 11 11 11 11 11 11 11 16 17 11 36 41 41 41 41 
41 41 41 41 41 41 40 6 100 0 101 0 102 0 104 0 103 10 115 38 38 38 38 38 38 38 38 38 38 38 38 38 38 116 11 11 11 11 11 11 85 11 84 11 11 36 41 41 41 41 
41 41 41 41 41 41 40 6 100 0 1 0 102 0 104 0 103 10 36 41 41 41 41 41 41 41 41 41 41 41 41 41 41 40 11 11 15 11 11 11 11 11 84 11 11 36 41 41 41 41 
41 41 41 41 41 41 40 6 100 0 101 0 102 0 104 0 103 10 36 41 41 41 41 41 41 41 41 41 41 41 41 41 41 40 11 11 11 11 87 11 11 11 11 85 11 36 41 41 41 41 
41 41 41 41 41 41 40 6 100 0 101 0 102 0 104 0 103 10 36 41 41 41 41 41 41 41 41 41 41 41 41 41 41 40 12 11 11 11 11 14 11 11 84 11 11 36 41 41 41 41 
41 41 41 41 41 41 40 6 100 0 101 0 102 0 104 0 103 10 36 41 41 41 41 41 41 41 41 41 41 41 41 41 41 40 11 11 11 11 11 11 22 23 11 11 11 36 41 41 41 41 
41 41 41 41 41 41 40 6 100 0 101 0 102 0 104 0 103 10 36 41 41 41 41 41 41 41 41 41 41 41 41 41 41 40 87 11 11 87 11 11 20 21 11 11 11 36 41 41 41 41 
41 41 41 41 41 41 40 6 100 0 101 0 1 0 104 0 103 10 36 41 41 41 41 41 41 41 41 41 41 41 41 41 41 40 11 11 11 11 11 11 11 22 23 11 11 36 41 41 41 41 
41 41 41 41 41 41 40 6 100 0 101 0 102 0 104 0 103 10 36 41 41 41 41 41 41 41 41 41 41 41 41 41 41 40 11 14 11 11 11 12 11 20 21 11 11 36 41 41 41 41 
41 41 41 41 41 41 40 6 100 0 101 0 102 0 104 0 103 10 36 41 41 41 41 41 41 41 41 41 41 41 41 41 41 40 11 11 11 11 11 11 22 23 11 14 11 36 41 41 41 41 
41 41 41 41 41 41 40 6 100 0 101 0 102 0 104 1 103 10 36 41 41 41 41 41 41 41 41 41 41 41 41 41 41 40 11 87 11 11 11 11 20 21 11 11 11 36 41 41 41 41 
41 41 41 41 41 41 40 121 7 7 7 7 7 7 7 7 87 120 36 41 41 41 41 41 41 41 41 41 41 41 41 41 41 40 11 11 11 15 11 11 86 11 11 11 11 36 41 41 41 41 
41 41 41 41 41 41 40 98 11 98 11 98 15 98 11 98 11 98 36 41 41 41 41 41 41 41 41 41 41 41 41 41 41 40 11 11 15 11 15 11 86 11 11 11 14 36 41 41 41 41 
41 41 41 41 41 41 40 99 31 99 31 99 11 99 31 99 31 99 36 41 41 41 41 41 41 41 41 41 41 41 41 41 41 40 18 19 11 15 11 11 86 11 11 15 11 36 41 41 41 41 
41 41 41 41 41 41 40 11 11 11 11 11 11 11 11 11 11 11 36 41 41 41 41 41 41 41 41 41 41 41 41 41 41 40 16 17 85 84 85 84 11 11 11 11 11 36 41 41 41 41 
41 41 41 41 41 41 40 11 11 12 11 11 15 11 11 13 11 11 36 41 41 41 41 41 41 41 41 41 41 41 41 41 41 40 11 11 11 11 11 11 11 15 11 11 11 36 41 41 41 41 
41 41 41 41 41 41 40 13 11 11 11 15 11 15 11 11 11 14 36 41 41 41 41 41 41 41 41 41 41 41 41 41 41 39 38 38 38 38 38 38 38 38 38 38 38 37 41 41 41 41 
41 41 41 41 41 41 40 18 19 11 11 11 15 11 11 11 11 11 36 41 41 41 41 41 41 41 41 41 41 41 41 41 41 41 41 41 41 41 41 41 41 41 41 41 41 41 41 41 41 41 
41 41 41 41 41 41 40 16 17 13 11 11 11 11 11 11 12 11 36 41 41 41 41 41 41 41 41 41 41 41 41 41 41 41 41 41 41 41 41 41 41 41 41 41 41 41 41 41 41 41 
41 41 41 41 41 41 40 11 11 18 19 14 11 86 86 14 84 87 36 41 41 41 41 41 41 41 41 41 41 41 41 41 41 41 41 41 41 41 41 41 41 41 41 41 41 41 41 41 41 41 
41 41 41 41 41 41 40 11 11 16 17 85 85 11 11 84 11 11 36 41 41 41 41 41 41 41 41 41 41 41 41 41 41 41 41 41 41 41 41 41 41 41 41 41 41 41 41 41 41 41 
41 41 41 41 41 41 40 11 11 11 11 11 11 11 11 11 11 11 36 41 41 41 41 41 41 41 41 41 41 41 41 41 41 41 41 41 41 41 41 41 41 41 41 41 41 41 41 41 41 41 
41 41 41 41 41 41 39 38 38 38 38 38 38 38 38 38 38 38 37 41 41 41 41 41 41 41 41 41 41 41 41 41 41 41 41 41 41 41 41 41 41 41 41 41 41 41 41 41 41 41 
41 41 41 41 41 41 41 41 41 41 41 41 41 41 41 41 41 41 41 41 41 41 41 41 41 41 41 41 41 41 41 41 41 41 41 41 41 41 41 41 41 41 41 41 41 41 41 41 41 41 
41 41 41 41 41 41 41 41 41 41 41 41 41 41 41 41 41 41 41 41 41 41 41 41 41 41 41 41 41 41 41 41 41 41 41 41 41 41 41 41 41 41 41 41 41 41 41 41 41 41 
41 41 41 41 41 41 41 41 41 41 41 41 41 41 41 41 41 41 41 41 41 41 41 41 41 41 41 41 41 41 41 41 41 41 41 41 41 41 41 41 41 41 41 41 41 41 41 41 41 41 
41 41 41 41 41 41 41 41 41 41 41 41 41 41 41 41 41 41 41 41 41 41 41 41 41 41 41 41 41 41 41 41 41 41 41 41 41 41 41 41 41 41 41 41 41 41 41 41 41 41 
41 41 41 41 41 41 41 41 41 41 41 41 41 41 41 41 41 41 41 41 41 41 41 41 41 41 41 41 41 41 41 41 41 41 41 41 41 41 41 41 41 41 41 41 41 41 41 41 41 41 
41 41 41 41 41 41 41 41 41 41 41 41 41 41 41 41 41 41 41 41 41 41 41 41 41 41 41 41 41 41 41 41 41 41 41 41 41 41 41 41 41 41 41 41 41 41 41 41 41 41 
41 41 41 41 41 41 41 41 41 41 41 41 41 41 41 41 41 41 41 41 41 41 41 41 41 41 41 41 41 41 41 41 41 41 41 41 41 41 41 41 41 41 41 41 41 41 41 41 41 41 
41 41 41 41 41 41 41 41 41 41 41 41 41 41 41 41 41 41 41 41 41 41 41 41 41 41 41 41 41 41 41 41 41 41 41 41 41 41 41 41 41 41 41 41 41 41 41 41 41 41 
41 41 41 41 41 41 41 41 41 41 41 41 41 41 41 41 41 41 41 41 41 41 41 41 41 41 41 41 41 41 41 41 41 41 41 41 41 41 41 41 41 41 41 41 41 41 41 41 41 41 
41 41 41 41 41 41 41 41 41 41 41 41 41 41 41 41 41 41 41 41 41 41 41 41 41 41 41 41 41 41 41 41 41 41 41 41 41 41 41 41 41 41 41 41 41 41 41 41 41 41 
41 41 41 41 41 41 41 41 41 41 41 41 41 41 41 41 41 41 41 41 41 41 41 41 41 41 41 41 41 41 41 41 41 41 41 41 41 41 41 41 41 41 41 41 41 41 41 41 41 41 
41 41 41 41 41 41 41 41 41 41 41 41 41 41 41 41 41 41 41 41 41 41 41 41 41 41 41 41 41 41 41 41 41 41 41 41 41 41 41 41 41 41 41 41 41 41 41 41 41 41 

0 0 0 0 0 0 0 0 0 0 0 0 0 0 0 0 0 0 0 0 0 0 0 0 0 0 0 0 0 0 0 0 0 0 0 0 0 0 0 0 0 0 0 0 0 0 0 0 0 0 
0 0 0 0 0 0 0 0 0 0 0 0 0 0 0 0 0 0 0 0 0 0 0 0 0 0 0 0 0 0 0 0 0 0 0 0 0 0 0 0 0 0 0 0 0 0 0 0 0 0 
0 0 0 0 0 0 0 0 0 0 0 0 0 0 0 0 0 0 0 0 0 0 0 0 0 0 0 0 0 0 0 0 0 0 0 0 0 0 0 0 0 0 0 0 0 0 0 0 0 0 
0 0 0 0 0 0 0 0 0 99 0 0 0 0 0 0 0 0 0 0 0 0 0 0 0 0 0 0 0 0 0 0 0 0 0 0 0 0 0 0 0 0 0 0 0 0 0 0 0 0 
0 0 0 0 0 0 0 0 0 0 0 0 0 0 0 0 0 0 0 0 0 0 0 0 0 0 0 0 0 0 0 0 0 0 0 0 0 0 0 0 0 0 0 0 0 0 0 0 0 0 
0 0 0 0 0 0 0 0 0 0 0 0 0 0 0 0 0 0 0 0 0 0 0 0 0 0 0 0 0 0 0 0 0 0 0 0 0 0 0 0 3 0 0 0 0 0 0 0 0 0 
0 0 0 0 0 0 0 0 0 0 0 0 0 0 0 0 0 0 0 0 0 0 0 0 0 0 0 0 0 0 0 0 0 0 0 0 0 0 0 0 0 0 0 0 0 0 0 0 0 0 
0 0 0 0 0 0 0 0 0 0 0 0 0 0 0 0 0 0 0 0 0 0 0 0 0 0 0 0 0 0 0 0 0 0 0 0 0 0 0 0 0 0 0 0 0 0 0 0 0 0 
0 0 0 0 0 0 0 0 0 0 0 0 0 0 0 0 0 0 0 0 0 0 0 0 0 0 0 0 0 0 0 0 0 0 0 0 0 0 0 0 0 0 0 0 0 0 0 0 0 0 
0 0 0 0 0 0 0 0 0 0 0 0 0 0 0 0 0 0 0 0 0 0 0 0 0 0 0 0 0 0 0 0 0 0 0 0 0 0 0 0 0 0 0 0 0 0 0 0 0 0 
0 0 0 0 0 0 0 0 0 0 0 0 0 0 0 0 0 0 0 0 0 0 0 0 0 0 0 0 0 0 0 0 0 0 0 0 0 0 0 0 0 0 0 0 0 0 0 0 0 0 
0 0 0 0 0 0 0 0 0 0 0 0 1 0 0 0 0 0 0 0 0 0 0 0 0 0 0 0 0 0 0 0 0 0 0 0 0 0 0 0 0 0 0 0 0 0 0 0 0 0 
0 0 0 0 0 0 0 0 0 0 0 0 0 0 0 0 0 0 0 0 0 0 0 0 0 0 0 0 0 0 0 0 0 0 0 0 0 1 0 0 0 0 0 0 0 0 0 0 0 0 
0 0 0 0 0 0 0 0 0 0 0 0 0 0 0 0 0 0 0 0 0 0 0 0 0 0 0 0 0 0 0 0 0 0 0 0 0 0 0 0 0 0 0 0 0 0 0 0 0 0 
0 0 0 0 0 0 0 0 0 0 0 0 0 0 0 0 0 0 0 0 0 0 0 0 0 0 0 0 0 0 0 0 0 0 0 0 0 0 0 0 0 0 0 0 0 0 0 0 0 0 
0 0 0 0 0 0 0 1 0 0 0 0 0 0 0 0 0 0 0 0 0 0 0 0 0 0 0 0 0 0 0 0 0 0 0 0 1 0 0 0 0 0 0 0 0 0 0 0 0 0 
0 0 0 0 0 0 0 0 0 0 0 0 0 0 0 0 0 0 0 0 0 0 0 0 0 0 0 0 0 0 0 0 0 0 0 0 0 0 0 0 0 0 0 0 0 0 0 0 0 0 
0 0 0 0 0 0 0 0 0 0 0 0 0 0 0 0 0 0 0 0 0 0 0 0 0 0 0 0 0 0 0 0 0 0 0 5 0 0 0 0 5 0 0 0 0 0 0 0 0 0 
0 0 0 0 0 0 0 0 0 1 0 0 0 1 0 0 0 0 0 0 0 0 0 0 0 0 0 0 0 0 0 0 0 0 0 0 0 0 5 0 0 0 0 0 0 0 0 0 0 0 
0 0 0 0 0 0 0 0 0 0 0 0 0 0 0 0 0 0 0 0 0 0 0 0 0 0 0 0 0 0 0 0 0 0 0 0 0 0 0 0 0 0 0 0 0 0 0 0 0 0 
0 0 0 0 0 0 0 0 0 0 0 0 0 0 0 0 0 0 0 0 0 0 0 0 0 0 0 0 0 0 0 0 0 0 5 0 0 0 0 0 0 0 0 0 0 0 0 0 0 0 
0 0 0 0 0 0 0 0 0 0 0 1 0 0 0 0 0 0 0 0 0 0 0 0 0 0 0 0 0 0 0 0 0 0 0 1 5 0 0 0 0 0 0 0 0 0 0 0 0 0 
0 0 0 0 0 0 0 0 0 0 0 0 0 0 0 0 0 0 0 0 0 0 0 0 0 0 0 0 0 0 0 0 0 0 0 0 0 5 0 0 0 0 0 0 0 0 0 0 0 0 
0 0 0 0 0 0 0 0 0 0 0 0 0 0 0 0 0 0 0 0 0 0 0 0 0 0 0 0 0 0 0 0 0 0 0 5 0 0 0 5 0 0 0 0 0 0 0 0 0 0 
0 0 0 0 0 0 0 0 0 0 0 0 0 0 0 0 0 0 0 0 0 0 0 0 0 0 0 0 0 0 0 0 0 0 0 0 0 0 0 0 0 0 0 0 0 0 0 0 0 0 
0 0 0 0 0 0 0 0 0 0 0 5 0 5 0 0 0 0 0 0 0 0 0 0 0 0 0 0 0 0 0 0 0 0 0 0 0 1 5 0 0 0 0 0 0 0 0 0 0 0 
0 0 0 0 0 0 0 0 0 0 0 0 0 0 0 0 0 0 0 0 0 0 0 0 0 0 0 0 0 0 0 0 0 0 0 5 0 0 0 0 0 0 0 0 0 0 0 0 0 0 
0 0 0 0 0 0 0 0 0 0 0 0 0 0 0 0 0 0 0 0 0 0 0 0 0 0 0 0 0 0 0 0 0 0 0 0 0 2 0 0 0 0 0 0 0 0 0 0 0 0 
0 0 0 0 0 0 0 0 0 0 0 0 1 0 0 0 0 0 0 0 0 0 0 0 0 0 0 0 0 0 0 0 0 0 0 0 0 0 0 0 0 0 0 0 0 0 0 0 0 0 
0 0 0 0 0 0 0 0 0 1 0 0 0 0 0 0 0 0 0 0 0 0 0 0 0 0 0 0 0 0 0 0 0 0 0 0 0 0 0 0 0 0 0 0 0 0 0 0 0 0 
0 0 0 0 0 0 0 0 0 0 0 0 0 0 0 0 0 0 0 0 0 0 0 0 0 0 0 0 0 0 0 0 0 0 0 0 0 0 0 0 0 0 0 0 0 0 0 0 0 0 
0 0 0 0 0 0 0 0 0 0 0 0 2 0 0 0 0 0 0 0 0 0 0 0 0 0 0 0 0 0 0 0 0 0 0 0 0 0 0 0 0 0 0 0 0 0 0 0 0 0 
0 0 0 0 0 0 0 0 0 0 0 0 0 0 0 0 0 0 0 0 0 0 0 0 0 0 0 0 0 0 0 0 0 0 0 0 0 0 0 0 0 0 0 0 0 0 0 0 0 0 
0 0 0 0 0 0 0 0 0 0 0 0 0 0 0 0 0 0 0 0 0 0 0 0 0 0 0 0 0 0 0 0 0 0 0 0 0 0 0 0 0 0 0 0 0 0 0 0 0 0 
0 0 0 0 0 0 0 0 0 0 0 0 0 0 0 0 0 0 0 0 0 0 0 0 0 0 0 0 0 0 0 0 0 0 0 0 0 0 0 0 0 0 0 0 0 0 0 0 0 0 
0 0 0 0 0 0 0 0 0 0 0 0 0 0 0 0 0 0 0 0 0 0 0 0 0 0 0 0 0 0 0 0 0 0 0 0 0 0 0 0 0 0 0 0 0 0 0 0 0 0 
0 0 0 0 0 0 0 0 0 0 0 0 0 0 0 0 0 0 0 0 0 0 0 0 0 0 0 0 0 0 0 0 0 0 0 0 0 0 0 0 0 0 0 0 0 0 0 0 0 0 
0 0 0 0 0 0 0 0 0 0 0 0 0 0 0 0 0 0 0 0 0 0 0 0 0 0 0 0 0 0 0 0 0 0 0 0 0 0 0 0 0 0 0 0 0 0 0 0 0 0 
0 0 0 0 0 0 0 0 0 0 0 0 0 0 0 0 0 0 0 0 0 0 0 0 0 0 0 0 0 0 0 0 0 0 0 0 0 0 0 0 0 0 0 0 0 0 0 0 0 0 
0 0 0 0 0 0 0 0 0 0 0 0 0 0 0 0 0 0 0 0 0 0 0 0 0 0 0 0 0 0 0 0 0 0 0 0 0 0 0 0 0 0 0 0 0 0 0 0 0 0 
0 0 0 0 0 0 0 0 0 0 0 0 0 0 0 0 0 0 0 0 0 0 0 0 0 0 0 0 0 0 0 0 0 0 0 0 0 0 0 0 0 0 0 0 0 0 0 0 0 0 
0 0 0 0 0 0 0 0 0 0 0 0 0 0 0 0 0 0 0 0 0 0 0 0 0 0 0 0 0 0 0 0 0 0 0 0 0 0 0 0 0 0 0 0 0 0 0 0 0 0 
0 0 0 0 0 0 0 0 0 0 0 0 0 0 0 0 0 0 0 0 0 0 0 0 0 0 0 0 0 0 0 0 0 0 0 0 0 0 0 0 0 0 0 0 0 0 0 0 0 0 
0 0 0 0 0 0 0 0 0 0 0 0 0 0 0 0 0 0 0 0 0 0 0 0 0 0 0 0 0 0 0 0 0 0 0 0 0 0 0 0 0 0 0 0 0 0 0 0 0 0 
0 0 0 0 0 0 0 0 0 0 0 0 0 0 0 0 0 0 0 0 0 0 0 0 0 0 0 0 0 0 0 0 0 0 0 0 0 0 0 0 0 0 0 0 0 0 0 0 0 0 
0 0 0 0 0 0 0 0 0 0 0 0 0 0 0 0 0 0 0 0 0 0 0 0 0 0 0 0 0 0 0 0 0 0 0 0 0 0 0 0 0 0 0 0 0 0 0 0 0 0 
0 0 0 0 0 0 0 0 0 0 0 0 0 0 0 0 0 0 0 0 0 0 0 0 0 0 0 0 0 0 0 0 0 0 0 0 0 0 0 0 0 0 0 0 0 0 0 0 0 0 
0 0 0 0 0 0 0 0 0 0 0 0 0 0 0 0 0 0 0 0 0 0 0 0 0 0 0 0 0 0 0 0 0 0 0 0 0 0 0 0 0 0 0 0 0 0 0 0 0 0 
0 0 0 0 0 0 0 0 0 0 0 0 0 0 0 0 0 0 0 0 0 0 0 0 0 0 0 0 0 0 0 0 0 0 0 0 0 0 0 0 0 0 0 0 0 0 0 0 0 0 
0 0 0 0 0 0 0 0 0 0 0 0 0 0 0 0 0 0 0 0 0 0 0 0 0 0 0 0 0 0 0 0 0 0 0 0 0 0 0 0 0 0 0 0 0 0 0 0 0 0 
