BARN1,50,50,10,12,25,2,2
0 0 0 0 0 0 0 0 0 0 0 0 0 0 0 0 0 0 0 0 0 0 0 0 0 0 0 0 0 0 0 0 0 0 0 0 0 0 0 0 0 0 0 0 0 0 0 0 0 0 
0 0 0 0 0 0 0 0 0 0 0 0 0 0 0 0 0 0 0 0 0 0 0 0 0 0 0 0 0 0 0 0 0 0 0 0 0 0 0 0 0 0 0 0 0 0 0 0 0 0 
0 0 0 0 0 0 0 0 0 0 0 0 0 0 0 0 0 0 0 0 0 0 0 0 0 0 0 0 0 0 0 0 0 0 0 0 0 0 0 0 0 0 0 0 0 0 0 0 0 0 
0 0 0 0 0 0 0 0 0 0 0 0 0 0 0 0 0 0 0 0 0 0 0 0 0 0 0 0 0 0 0 0 0 0 0 0 0 0 0 0 0 0 0 0 0 0 0 0 0 0 
0 0 0 0 0 0 8 7 7 7 7 7 7 7 7 7 7 7 7 7 7 7 7 7 7 7 7 7 7 7 7 7 7 7 7 7 7 9 0 0 0 0 0 0 0 0 0 0 0 0 
0 0 0 0 0 0 10 30 31 31 31 31 31 31 31 31 31 31 31 31 31 31 31 31 31 31 31 31 31 31 31 31 31 31 31 31 32 6 0 0 0 0 0 0 0 0 0 0 0 0 
0 0 0 0 0 0 10 28 42 43 44 64 45 11 11 11 11 11 13 11 11 11 12 11 11 11 85 11 11 11 11 11 11 11 11 84 29 6 0 0 0 0 0 0 0 0 0 0 0 0 
0 0 0 0 0 0 10 28 46 47 48 49 50 11 11 12 11 11 11 11 86 11 11 11 11 11 11 11 11 11 11 11 11 11 11 11 29 6 0 0 0 0 0 0 0 0 0 0 0 0 
0 0 0 0 0 0 10 28 51 52 53 54 55 11 12 11 12 11 11 11 11 11 11 22 23 11 11 11 11 84 11 11 11 11 11 11 29 6 0 0 0 0 0 0 0 0 0 0 0 0 
0 0 0 0 0 0 10 28 56 57 58 59 60 11 11 12 11 11 11 11 11 11 11 20 21 11 11 11 11 11 11 11 22 23 11 11 29 6 0 0 0 0 0 0 0 0 0 0 0 0 
0 0 0 0 0 0 10 28 61 62 63 65 66 11 11 11 11 11 11 11 11 11 11 13 13 11 11 88 11 11 11 11 20 21 11 11 29 6 0 0 0 0 0 0 0 0 0 0 0 0 
0 0 0 0 0 0 10 28 86 93 82 83 86 11 11 11 11 85 85 11 11 11 11 11 11 11 11 11 11 11 11 84 11 11 11 11 29 6 0 0 0 0 0 0 0 0 0 0 0 0 
0 0 0 0 0 0 10 28 86 93 93 93 86 12 11 11 11 11 11 11 11 14 11 11 11 12 11 11 11 11 84 11 11 11 11 11 29 6 0 0 0 0 0 0 0 0 0 0 0 0 
0 0 0 0 0 0 10 28 86 93 93 93 86 82 83 25 82 83 25 82 83 25 82 83 25 82 83 93 93 11 11 84 11 93 93 11 29 6 0 0 0 0 0 0 0 0 0 0 0 0 
0 0 0 0 0 0 10 28 86 93 93 93 88 11 11 11 11 11 11 11 11 11 11 11 11 11 11 93 93 11 11 84 11 93 93 11 29 6 0 0 0 0 0 0 0 0 0 0 0 0 
0 0 0 0 0 0 10 28 86 93 93 93 86 82 83 25 82 83 25 82 83 25 82 83 25 82 83 93 93 11 11 84 11 93 93 11 29 6 0 0 0 0 0 0 0 0 0 0 0 0 
0 0 0 0 0 0 10 28 85 93 93 93 93 93 93 93 93 93 93 93 93 93 93 93 93 93 93 93 93 11 22 23 11 93 93 11 29 6 0 0 0 0 0 0 0 0 0 0 0 0 
0 0 0 0 0 0 10 28 85 93 93 93 93 93 93 93 93 93 93 93 93 93 93 93 93 93 93 93 93 11 20 21 11 93 93 11 29 6 0 0 0 0 0 0 0 0 0 0 0 0 
0 0 0 0 0 0 10 28 85 93 93 93 93 93 93 93 93 93 93 93 93 93 93 93 93 93 93 93 93 11 87 11 11 93 93 11 29 6 0 0 0 0 0 0 0 0 0 0 0 0 
0 0 0 0 0 0 10 28 11 18 19 11 11 11 18 19 11 11 11 86 87 88 88 88 87 87 86 86 86 87 11 11 11 93 93 11 29 6 0 0 0 0 0 0 0 0 0 0 0 0 
0 0 0 0 0 0 10 28 11 16 17 11 18 19 16 17 18 19 85 93 93 93 93 93 93 93 93 93 93 11 84 85 11 93 93 11 29 6 0 0 0 0 0 0 0 0 0 0 0 0 
0 0 0 0 0 0 10 28 11 11 11 85 16 17 11 11 16 17 93 93 93 93 93 93 93 93 93 93 93 11 85 84 11 93 93 11 29 6 0 0 0 0 0 0 0 0 0 0 0 0 
0 0 0 0 0 0 10 28 18 19 11 11 11 11 11 85 11 11 93 93 93 30 31 31 31 32 93 93 93 11 18 19 11 93 93 11 29 6 0 0 0 0 0 0 0 0 0 0 0 0 
0 0 0 0 0 0 10 28 16 17 85 11 11 18 19 11 11 85 93 93 93 28 67 68 69 29 93 93 93 11 16 17 11 93 93 11 29 6 0 0 0 0 0 0 0 0 0 0 0 0 
0 0 0 0 0 0 10 28 11 11 85 85 11 16 17 11 11 85 93 93 93 28 70 71 72 29 93 93 93 11 11 11 11 93 93 11 29 6 0 0 0 0 0 0 0 0 0 0 0 0 
0 0 0 0 0 0 10 28 11 11 93 93 93 93 93 93 93 93 93 93 93 28 73 74 75 29 93 93 93 93 93 93 93 93 93 11 29 6 0 0 0 0 0 0 0 0 0 0 0 0 
0 0 0 0 0 0 10 28 11 11 93 93 93 93 93 93 93 93 93 93 93 28 76 77 78 29 93 93 93 93 93 93 93 93 93 11 29 6 0 0 0 0 0 0 0 0 0 0 0 0 
0 0 0 0 0 0 10 28 11 11 93 93 93 93 93 93 93 93 93 93 93 28 79 80 81 29 93 93 93 93 93 93 93 93 93 11 29 6 0 0 0 0 0 0 0 0 0 0 0 0 
0 0 0 0 0 0 10 28 22 23 93 93 93 11 30 82 83 25 82 83 25 82 83 11 82 83 11 11 11 11 11 22 23 11 11 11 29 6 0 0 0 0 0 0 0 0 0 0 0 0 
0 0 0 0 0 0 10 28 20 21 93 93 93 11 28 11 11 11 11 11 11 11 11 11 11 29 18 19 11 11 84 20 21 84 11 11 29 6 0 0 0 0 0 0 0 0 0 0 0 0 
0 0 0 0 0 0 10 28 11 11 93 93 93 11 82 83 31 82 83 31 82 83 31 82 83 26 16 17 85 85 11 11 11 11 86 86 29 6 0 0 0 0 0 0 0 0 0 0 0 0 
0 0 0 0 0 0 10 28 11 11 93 93 93 93 93 93 93 93 93 93 93 93 93 93 93 93 93 93 93 93 93 93 93 93 93 93 29 6 0 0 0 0 0 0 0 0 0 0 0 0 
0 0 0 0 0 0 10 28 11 11 93 93 93 93 93 93 93 93 93 93 93 93 93 93 93 93 93 93 93 93 93 93 93 93 93 93 29 6 0 0 0 0 0 0 0 0 0 0 0 0 
0 0 0 0 0 0 10 28 15 11 93 93 93 93 93 93 93 93 93 93 93 93 93 93 22 23 22 23 22 23 93 93 93 93 93 93 29 6 0 0 0 0 0 0 0 0 0 0 0 0 
0 0 0 0 0 0 10 28 11 11 11 11 87 88 86 84 86 84 84 86 86 84 86 84 20 21 20 21 20 21 84 11 11 93 93 93 29 6 0 0 0 0 0 0 0 0 0 0 0 0 
0 0 0 0 0 0 10 28 18 19 11 11 11 15 11 11 11 11 13 11 11 11 11 11 11 11 11 11 15 11 84 11 11 93 93 93 29 6 0 0 0 0 0 0 0 0 0 0 0 0 
0 0 0 0 0 0 10 28 16 17 11 11 11 11 11 11 15 11 11 11 11 11 11 11 11 11 11 15 11 15 11 18 19 93 93 93 29 6 0 0 0 0 0 0 0 0 0 0 0 0 
0 0 0 0 0 0 10 28 85 15 11 11 14 11 11 11 11 11 11 11 14 11 11 15 11 11 11 11 15 11 11 16 17 93 93 93 29 6 0 0 0 0 0 0 0 0 0 0 0 0 
0 0 0 0 0 0 10 24 25 25 25 25 25 25 25 25 25 25 25 25 25 25 25 25 25 25 25 25 25 25 25 25 25 25 11 25 26 6 0 0 0 0 0 0 0 0 0 0 0 0 
0 0 0 0 0 0 4 3 3 3 3 3 3 3 3 3 3 3 3 3 3 3 3 3 3 3 3 3 3 3 3 3 3 3 3 3 3 5 0 0 0 0 0 0 0 0 0 0 0 0 
0 0 0 0 0 0 0 0 0 0 0 0 0 0 0 0 0 0 0 0 0 0 0 0 0 0 0 0 0 0 0 0 0 0 0 0 0 0 0 0 0 0 0 0 0 0 0 0 0 0 
0 0 0 0 0 0 0 0 0 0 0 0 0 0 0 0 0 0 0 0 0 0 0 0 0 0 0 0 0 0 0 0 0 0 0 0 0 0 0 0 0 0 0 0 0 0 0 0 0 0 
0 0 0 0 0 0 0 0 0 0 0 0 0 0 0 0 0 0 0 0 0 0 0 0 0 0 0 0 0 0 0 0 0 0 0 0 0 0 0 0 0 0 0 0 0 0 0 0 0 0 
0 0 0 0 0 0 0 0 0 0 0 0 0 0 0 0 0 0 0 0 0 0 0 0 0 0 0 0 0 0 0 0 0 0 0 0 0 0 0 0 0 0 0 0 0 0 0 0 0 0 
0 0 0 0 0 0 0 0 0 0 0 0 0 0 0 0 0 0 0 0 0 0 0 0 0 0 0 0 0 0 0 0 0 0 0 0 0 0 0 0 0 0 0 0 0 0 0 0 0 0 
0 0 0 0 0 0 0 0 0 0 0 0 0 0 0 0 0 0 0 0 0 0 0 0 0 0 0 0 0 0 0 0 0 0 0 0 0 0 0 0 0 0 0 0 0 0 0 0 0 0 
0 0 0 0 0 0 0 0 0 0 0 0 0 0 0 0 0 0 0 0 0 0 0 0 0 0 0 0 0 0 0 0 0 0 0 0 0 0 0 0 0 0 0 0 0 0 0 0 0 0 
0 0 0 0 0 0 0 0 0 0 0 0 0 0 0 0 0 0 0 0 0 0 0 0 0 0 0 0 0 0 0 0 0 0 0 0 0 0 0 0 0 0 0 0 0 0 0 0 0 0 
0 0 0 0 0 0 0 0 0 0 0 0 0 0 0 0 0 0 0 0 0 0 0 0 0 0 0 0 0 0 0 0 0 0 0 0 0 0 0 0 0 0 0 0 0 0 0 0 0 0 
0 0 0 0 0 0 0 0 0 0 0 0 0 0 0 0 0 0 0 0 0 0 0 0 0 0 0 0 0 0 0 0 0 0 0 0 0 0 0 0 0 0 0 0 0 0 0 0 0 0 

0 0 0 0 0 0 0 0 0 0 0 0 0 0 0 0 0 0 0 0 0 0 0 0 0 0 0 0 0 0 0 0 0 0 0 0 0 0 0 0 0 0 0 0 0 0 0 0 0 0 
0 0 0 0 0 0 0 0 0 0 0 0 0 0 0 0 0 0 0 0 0 0 0 0 0 0 0 0 0 0 0 0 0 0 0 0 0 0 0 0 0 0 0 0 0 0 0 0 0 0 
0 0 0 0 0 0 0 0 0 0 0 0 0 0 0 0 0 0 0 0 0 0 0 0 0 0 0 0 0 0 0 0 0 0 0 0 0 0 0 0 0 0 0 0 0 0 0 0 0 0 
0 0 0 0 0 0 0 0 0 0 0 0 0 0 0 0 0 0 0 0 0 0 0 0 0 0 0 0 0 0 0 0 0 0 0 0 0 0 0 0 0 0 0 0 0 0 0 0 0 0 
0 0 0 0 0 0 0 0 0 0 0 0 0 0 0 0 0 0 0 0 0 0 0 0 0 0 0 0 0 0 0 0 0 0 0 0 0 0 0 0 0 0 0 0 0 0 0 0 0 0 
0 0 0 0 0 0 0 0 0 0 0 0 0 0 0 0 0 0 0 0 0 0 0 0 0 0 0 0 0 0 0 0 0 0 0 0 0 0 0 0 0 0 0 0 0 0 0 0 0 0 
0 0 0 0 0 0 0 0 0 0 0 0 0 0 0 0 0 0 0 0 0 0 0 0 0 0 0 0 0 0 0 1 0 0 0 0 0 0 0 0 0 0 0 0 0 0 0 0 0 0 
0 0 0 0 0 0 0 0 0 0 0 0 0 0 99 0 0 0 0 0 0 0 0 0 0 0 0 0 0 0 0 0 0 0 0 0 0 0 0 0 0 0 0 0 0 0 0 0 0 0 
0 0 0 0 0 0 0 0 0 0 0 0 0 0 0 2 0 0 0 0 0 0 0 0 0 0 0 0 0 0 0 0 0 0 0 0 0 0 0 0 0 0 0 0 0 0 0 0 0 0 
0 0 0 0 0 0 0 0 0 0 0 0 0 0 0 0 0 0 0 0 0 0 0 0 0 0 0 0 0 0 0 0 0 0 0 0 0 0 0 0 0 0 0 0 0 0 0 0 0 0 
0 0 0 0 0 0 0 0 0 0 0 0 0 0 0 0 0 0 0 0 1 0 0 0 0 0 0 0 0 0 0 0 0 0 0 0 0 0 0 0 0 0 0 0 0 0 0 0 0 0 
0 0 0 0 0 0 0 0 0 1 0 0 0 0 0 0 0 0 0 0 0 0 0 0 0 0 0 0 0 0 0 0 0 0 0 0 0 0 0 0 0 0 0 0 0 0 0 0 0 0 
0 0 0 0 0 0 0 0 0 0 0 0 0 0 0 0 0 0 0 0 0 0 0 0 0 0 0 0 0 0 0 0 0 0 0 0 0 0 0 0 0 0 0 0 0 0 0 0 0 0 
0 0 0 0 0 0 0 0 0 0 0 0 0 0 0 0 0 0 0 0 0 0 0 0 0 0 0 0 0 0 0 0 0 0 0 0 0 0 0 0 0 0 0 0 0 0 0 0 0 0 
0 0 0 0 0 0 0 0 0 1 0 0 0 0 0 0 0 0 0 0 0 0 0 0 0 0 0 0 0 1 0 0 0 0 0 0 0 0 0 0 0 0 0 0 0 0 0 0 0 0 
0 0 0 0 0 0 0 0 0 0 0 0 0 0 0 0 0 0 0 0 0 0 0 0 0 0 0 0 0 0 0 0 0 0 0 0 0 0 0 0 0 0 0 0 0 0 0 0 0 0 
0 0 0 0 0 0 0 0 0 0 0 1 0 0 0 0 0 0 1 0 0 0 0 0 0 0 0 0 0 0 0 0 0 0 1 0 0 0 0 0 0 0 0 0 0 0 0 0 0 0 
0 0 0 0 0 0 0 0 0 0 1 0 0 0 0 0 0 0 0 0 0 0 0 0 1 0 0 0 0 0 0 0 0 0 0 0 0 0 0 0 0 0 0 0 0 0 0 0 0 0 
0 0 0 0 0 0 0 0 0 0 0 0 0 0 0 0 0 0 0 0 0 0 0 0 0 0 0 0 0 0 0 0 0 0 0 0 0 0 0 0 0 0 0 0 0 0 0 0 0 0 
0 0 0 0 0 0 0 0 0 0 0 0 0 0 0 0 0 0 0 0 0 0 0 0 0 0 0 0 0 0 0 0 1 0 0 0 0 0 0 0 0 0 0 0 0 0 0 0 0 0 
0 0 0 0 0 0 0 0 0 0 0 0 0 0 0 0 0 0 0 0 0 0 0 0 0 0 0 0 0 0 0 0 0 0 0 0 0 0 0 0 0 0 0 0 0 0 0 0 0 0 
0 0 0 0 0 0 0 0 0 0 0 0 0 0 0 99 0 0 0 0 0 0 0 0 0 0 0 0 0 0 0 0 0 0 0 0 0 0 0 0 0 0 0 0 0 0 0 0 0 0 
0 0 0 0 0 0 0 0 0 0 0 0 0 0 0 0 0 0 0 0 0 0 0 0 0 0 0 0 0 0 0 0 0 0 0 0 0 0 0 0 0 0 0 0 0 0 0 0 0 0 
0 0 0 0 0 0 0 0 0 0 0 0 0 0 0 0 0 0 0 0 0 0 0 0 0 0 0 0 0 0 0 0 0 0 0 0 0 0 0 0 0 0 0 0 0 0 0 0 0 0 
0 0 0 0 0 0 0 0 0 0 0 0 0 0 0 0 0 0 0 0 0 0 0 0 0 0 0 0 0 0 0 0 0 0 0 0 0 0 0 0 0 0 0 0 0 0 0 0 0 0 
0 0 0 0 0 0 0 0 0 0 0 0 0 0 0 0 0 0 0 0 0 0 0 0 0 0 0 0 0 0 0 0 0 0 0 1 0 0 0 0 0 0 0 0 0 0 0 0 0 0 
0 0 0 0 0 0 0 0 0 0 0 0 0 0 0 0 0 0 0 0 0 0 0 0 0 0 0 0 0 0 0 0 0 0 0 0 0 0 0 0 0 0 0 0 0 0 0 0 0 0 
0 0 0 0 0 0 0 0 0 0 0 0 1 0 0 0 0 0 0 0 0 0 0 0 0 0 0 0 0 0 0 0 0 0 0 0 0 0 0 0 0 0 0 0 0 0 0 0 0 0 
0 0 0 0 0 0 0 0 0 0 0 0 0 0 0 0 0 0 0 0 0 0 0 0 0 0 0 0 0 0 0 0 0 0 0 0 0 0 0 0 0 0 0 0 0 0 0 0 0 0 
0 0 0 0 0 0 0 0 0 0 0 0 0 0 0 0 0 0 0 0 0 0 0 0 0 0 0 0 0 0 0 0 0 0 0 0 0 0 0 0 0 0 0 0 0 0 0 0 0 0 
0 0 0 0 0 0 0 0 0 0 0 0 0 0 0 0 0 0 0 0 0 0 0 0 0 0 0 0 0 0 0 0 0 0 0 0 0 0 0 0 0 0 0 0 0 0 0 0 0 0 
0 0 0 0 0 0 0 0 0 0 0 0 0 0 0 0 0 0 0 0 0 0 0 0 0 0 0 0 0 0 0 0 0 0 0 0 0 0 0 0 0 0 0 0 0 0 0 0 0 0 
0 0 0 0 0 0 0 0 0 0 0 0 0 0 0 0 0 0 0 0 0 0 0 0 0 0 0 0 0 0 0 0 0 0 0 0 0 0 0 0 0 0 0 0 0 0 0 0 0 0 
0 0 0 0 0 0 0 0 0 0 0 0 0 0 0 0 0 0 0 0 0 0 0 0 0 0 0 0 0 0 0 0 0 0 0 0 0 0 0 0 0 0 0 0 0 0 0 0 0 0 
0 0 0 0 0 0 0 0 0 0 0 0 0 0 0 0 0 0 0 0 0 0 0 0 0 0 0 0 0 0 0 0 0 0 1 0 0 0 0 0 0 0 0 0 0 0 0 0 0 0 
0 0 0 0 0 0 0 0 0 0 0 0 0 0 0 0 0 0 0 0 0 1 0 0 0 0 0 0 0 0 0 0 0 0 0 0 0 0 0 0 0 0 0 0 0 0 0 0 0 0 
0 0 0 0 0 0 0 0 0 0 0 0 0 0 0 0 0 0 0 0 0 0 0 0 0 0 0 0 2 0 0 0 0 0 1 0 0 0 0 0 0 0 0 0 0 0 0 0 0 0 
0 0 0 0 0 0 0 0 0 0 0 0 0 0 0 0 0 1 0 0 0 0 0 0 0 0 0 0 0 0 0 0 0 0 0 0 0 0 0 0 0 0 0 0 0 0 0 0 0 0 
0 0 0 0 0 0 0 0 0 0 0 0 0 0 0 0 0 0 0 0 0 0 0 0 0 0 0 0 0 0 0 0 0 0 3 0 0 0 0 0 0 0 0 0 0 0 0 0 0 0 
0 0 0 0 0 0 0 0 0 0 0 0 0 0 0 0 0 0 0 0 0 0 0 0 0 0 0 0 0 0 0 0 0 0 0 0 0 0 0 0 0 0 0 0 0 0 0 0 0 0 
0 0 0 0 0 0 0 0 0 0 0 0 0 0 0 0 0 0 0 0 0 0 0 0 0 0 0 0 0 0 0 0 0 0 0 0 0 0 0 0 0 0 0 0 0 0 0 0 0 0 
0 0 0 0 0 0 0 0 0 0 0 0 0 0 0 0 0 0 0 0 0 0 0 0 0 0 0 0 0 0 0 0 0 0 0 0 0 0 0 0 0 0 0 0 0 0 0 0 0 0 
0 0 0 0 0 0 0 0 0 0 0 0 0 0 0 0 0 0 0 0 0 0 0 0 0 0 0 0 0 0 0 0 0 0 0 0 0 0 0 0 0 0 0 0 0 0 0 0 0 0 
0 0 0 0 0 0 0 0 0 0 0 0 0 0 0 0 0 0 0 0 0 0 0 0 0 0 0 0 0 0 0 0 0 0 0 0 0 0 0 0 0 0 0 0 0 0 0 0 0 0 
0 0 0 0 0 0 0 0 0 0 0 0 0 0 0 0 0 0 0 0 0 0 0 0 0 0 0 0 0 0 0 0 0 0 0 0 0 0 0 0 0 0 0 0 0 0 0 0 0 0 
0 0 0 0 0 0 0 0 0 0 0 0 0 0 0 0 0 0 0 0 0 0 0 0 0 0 0 0 0 0 0 0 0 0 0 0 0 0 0 0 0 0 0 0 0 0 0 0 0 0 
0 0 0 0 0 0 0 0 0 0 0 0 0 0 0 0 0 0 0 0 0 0 0 0 0 0 0 0 0 0 0 0 0 0 0 0 0 0 0 0 0 0 0 0 0 0 0 0 0 0 
0 0 0 0 0 0 0 0 0 0 0 0 0 0 0 0 0 0 0 0 0 0 0 0 0 0 0 0 0 0 0 0 0 0 0 0 0 0 0 0 0 0 0 0 0 0 0 0 0 0 
0 0 0 0 0 0 0 0 0 0 0 0 0 0 0 0 0 0 0 0 0 0 0 0 0 0 0 0 0 0 0 0 0 0 0 0 0 0 0 0 0 0 0 0 0 0 0 0 0 0 
0 0 0 0 0 0 0 0 0 0 0 0 0 0 0 0 0 0 0 0 0 0 0 0 0 0 0 0 0 0 0 0 0 0 0 0 0 0 0 0 0 0 0 0 0 0 0 0 0 0 

